белить	бел:ROOT/ить:SUFF
белобрысый	бел:ROOT/обрысый:SUFF
белозубый	бел:ROOT/озубый:SUFF
белок	бел:ROOT/ок:SUFF
белолицый	бел:ROOT/олицый:SUFF
белолобый	бел:ROOT/олобый:SUFF
белоручка	бел:ROOT/оручка:SUFF
белорыбица	бел:ROOT/орыбица:SUFF
белохвостый	бел:ROOT/охвостый:SUFF
белошвейка	бел:ROOT/ошвейка:SUFF
белуга	бел:ROOT/уга:SUFF
белужий	бел:ROOT/ужий:SUFF
белый	бел:ROOT/ый:SUFF
побелка	по:PREF/бел:ROOT/ка:SUFF
берёза	берёз:ROOT/а:SUFF
берёзин	берёз:ROOT/ин:SUFF
берёзка	берёз:ROOT/ка:SUFF
берёзкин	берёз:ROOT/кин:SUFF
берёзовый	берёз:ROOT/овый:SUFF
берёзонька	берёз:ROOT/онька:SUFF
берёзонькин	берёз:ROOT/онькин:SUFF
берёзочка	берёз:ROOT/очка:SUFF
берёзушка	берёз:ROOT/ушка:SUFF
подберёзовик	под:PREF/берёз:ROOT/овик:SUFF
бойница	бой:ROOT/ница:SUFF
бойня	бой:ROOT/ня:SUFF
бойцовский	бой:ROOT/цовский:SUFF
бойцовый	бой:ROOT/цовый:SUFF
болезненный	бол:ROOT/езненный:SUFF
болезнь	бол:ROOT/езнь:SUFF
болельщик	бол:ROOT/ельщик:SUFF
болеть	бол:ROOT/еть:SUFF
болеющий	бол:ROOT/еющий:SUFF
больница	бол:ROOT/ьница:SUFF
больничка	бол:ROOT/ьничка:SUFF
больничный	бол:ROOT/ьничный:SUFF
больно	бол:ROOT/ьно:SUFF
больной	бол:ROOT/ьной:SUFF
болячка	бол:ROOT/ячка:SUFF
заболевание	за:PREF/бол:ROOT/евание:SUFF
заболеть	за:PREF/бол:ROOT/еть:SUFF
переболеть	пере:PREF/бол:ROOT/еть:SUFF
братан	брат:ROOT/ан:SUFF
братание	брат:ROOT/ание:SUFF
братец	брат:ROOT/ец:SUFF
братик	брат:ROOT/ик:SUFF
братишка	брат:ROOT/ишка:SUFF
братия	брат:ROOT/ия:SUFF
браток	брат:ROOT/ок:SUFF
братск	брат:ROOT/ск:SUFF
братский	брат:ROOT/ский:SUFF
братство	брат:ROOT/ство:SUFF
по-братски	по-:PREF/брат:ROOT/ски:SUFF
собрат	со:PREF/брат:ROOT
азбука	аз:PREF/бук:ROOT/а:SUFF
буква	бук:ROOT/ва:SUFF
буквальный	бук:ROOT/вальный:SUFF
букварик	бук:ROOT/варик:SUFF
букварный	бук:ROOT/варный:SUFF
букварь	бук:ROOT/варь:SUFF
буквенный	бук:ROOT/венный:SUFF
буквоед	бук:ROOT/воед:SUFF
букинист	бук:ROOT/инист:SUFF
буковка	бук:ROOT/овка:SUFF
веселить	весел:ROOT/ить:SUFF
веселиться	весел:ROOT/иться:SUFF
весело	весел:ROOT/о:SUFF
веселье	весел:ROOT/ье:SUFF
весельчак	весел:ROOT/ьчак:SUFF
веселящийся	весел:ROOT/ящийся:SUFF
веселёшенька	весел:ROOT/ёшенька:SUFF
повеселеть	по:PREF/весел:ROOT/еть:SUFF
повеселиться	по:PREF/весел:ROOT/иться:SUFF
развеселить	раз:PREF/весел:ROOT/ить:SUFF
весна	весн:ROOT/а:SUFF
весной	весн:ROOT/ой:SUFF
веснушечка	весн:ROOT/ушечка:SUFF
веснушки	весн:ROOT/ушки:SUFF
веснушчатый	весн:ROOT/ушчатый:SUFF
веснянка	весн:ROOT/янка:SUFF
весняночка	весн:ROOT/яночка:SUFF
вода	вод:ROOT/а:SUFF
водица	вод:ROOT/ица:SUFF
водичка	вод:ROOT/ичка:SUFF
водный	вод:ROOT/ный:SUFF
водовоз	вод:ROOT/овоз:SUFF
водоворот	вод:ROOT/оворот:SUFF
водолаз	вод:ROOT/олаз:SUFF
водопад	вод:ROOT/опад:SUFF
водопой	вод:ROOT/опой:SUFF
водопровод	вод:ROOT/опро:SUFF
водохлёб	вод:ROOT/охлёб:SUFF
водоём	вод:ROOT/оём:SUFF
водянка	вод:ROOT/янка:SUFF
водяной	вод:ROOT/яной:SUFF
наводнение	на:PREF/вод:ROOT/нение:SUFF
паводок	па:PREF/вод:ROOT/ок:SUFF
подводник	под:PREF/вод:ROOT/ник:SUFF
подводный	под:PREF/вод:ROOT/ный:SUFF
воробей	вороб:ROOT/ей:SUFF
воробейчик	вороб:ROOT/ейчик:SUFF
воробышек	вороб:ROOT/ышек:SUFF
воробьиная	вороб:ROOT/ьиная:SUFF
воробьиха	вороб:ROOT/ьиха:SUFF
воробьишка	вороб:ROOT/ьишка:SUFF
воробьята	вороб:ROOT/ьята:SUFF
воробьятник	вороб:ROOT/ьятник:SUFF
воробьёнок	вороб:ROOT/ьёнок:SUFF
ворон	ворон:ROOT
ворона	ворон:ROOT/а:SUFF
вороний	ворон:ROOT/ий:SUFF
воронушка	ворон:ROOT/ушка:SUFF
вороньё	ворон:ROOT/ьё:SUFF
воронята	ворон:ROOT/ята:SUFF
воронёнок	ворон:ROOT/ёнок:SUFF
воронёночек	ворон:ROOT/ёночек:SUFF
проворонить	про:PREF/ворон:ROOT/ить:SUFF
голова	голов:ROOT/а:SUFF
головастик	голов:ROOT/астик:SUFF
головища	голов:ROOT/ища:SUFF
головка	голов:ROOT/ка:SUFF
головной	голов:ROOT/ной:SUFF
головомойка	голов:ROOT/омойка:SUFF
головонька	голов:ROOT/онька:SUFF
головорез	голов:ROOT/орез:SUFF
головотяп	голов:ROOT/отяп:SUFF
головушка	голов:ROOT/ушка:SUFF
головёнка	голов:ROOT/ёнка:SUFF
заголовок	за:PREF/голов:ROOT/ок:SUFF
поголовно	по:PREF/голов:ROOT/но:SUFF
трёхголовый	трёх:PREF/голов:ROOT/ый:SUFF
впроголодь	впро:PREF/голод:ROOT/ь:SUFF
голод	голод:ROOT
голодание	голод:ROOT/ание:SUFF
голодать	голод:ROOT/ать:SUFF
голодающий	голод:ROOT/ающий:SUFF
голодно	голод:ROOT/но:SUFF
голодный	голод:ROOT/ный:SUFF
голодовка	голод:ROOT/овка:SUFF
голодуха	голод:ROOT/уха:SUFF
изголодаться	из:PREF/голод:ROOT/аться:SUFF
голосина	голос:ROOT/ина:SUFF
голосистый	голос:ROOT/истый:SUFF
голосить	голос:ROOT/ить:SUFF
голосишко	голос:ROOT/ишко:SUFF
голосище	голос:ROOT/ище:SUFF
голосование	голос:ROOT/ование:SUFF
голосовать	голос:ROOT/овать:SUFF
голосовой	голос:ROOT/овой:SUFF
голосок	голос:ROOT/ок:SUFF
подголосок	под:PREF/голос:ROOT/ок:SUFF
горе	гор:ROOT/е:SUFF
горевать	гор:ROOT/евать:SUFF
горемыка	гор:ROOT/емыка:SUFF
горемычный	гор:ROOT/емычный:SUFF
горестный	гор:ROOT/естный:SUFF
горесть	гор:ROOT/есть:SUFF
горькие	гор:ROOT/ькие:SUFF
горюн	гор:ROOT/юн:SUFF
горюшко	гор:ROOT/юшко:SUFF
пригорюниться	при:PREF/гор:ROOT/юниться:SUFF
грачата	грач:ROOT/ата:SUFF
грачик	грач:ROOT/ик:SUFF
грачиный	грач:ROOT/иный:SUFF
грачиха	грач:ROOT/иха:SUFF
грачишка	грач:ROOT/ишка:SUFF
грачище	грач:ROOT/ище:SUFF
грачовник	грач:ROOT/овник:SUFF
грачонок	грач:ROOT/онок:SUFF
груз	груз:ROOT
грузило	груз:ROOT/ило:SUFF
грузить	груз:ROOT/ить:SUFF
грузный	груз:ROOT/ный:SUFF
грузовик	груз:ROOT/овик:SUFF
грузчик	груз:ROOT/чик:SUFF
нагрузка	на:PREF/груз:ROOT/ка:SUFF
перегрузка	пере:PREF/груз:ROOT/ка:SUFF
погрузка	по:PREF/груз:ROOT/ка:SUFF
разгрузить	раз:PREF/груз:ROOT/ить:SUFF
гусак	гус:ROOT/ак:SUFF
гусыня	гус:ROOT/ыня:SUFF
гуськом	гус:ROOT/ьком:SUFF
гусята	гус:ROOT/ята:SUFF
гусятница	гус:ROOT/ятница:SUFF
гусёнок	гус:ROOT/ёнок:SUFF
гусёночек	гус:ROOT/ёночек:SUFF
гусиный	гус:ROOT/иный:SUFF
дворец	двор:ROOT/ец:SUFF
дворецкий	двор:ROOT/ецкий:SUFF
дворик	двор:ROOT/ик:SUFF
дворник	двор:ROOT/ник:SUFF
дворня	двор:ROOT/ня:SUFF
дворняжка	двор:ROOT/няжка:SUFF
дворовый	двор:ROOT/овый:SUFF
дворцовый	двор:ROOT/цовый:SUFF
дворянин	двор:ROOT/янин:SUFF
надворный	на:PREF/двор:ROOT/ный:SUFF
подворье	по:PREF/двор:ROOT/ье:SUFF
придворный	при:PREF/двор:ROOT/ный:SUFF
добренький	добр:ROOT/енький:SUFF
добро	добр:ROOT/о:SUFF
добровольно	добр:ROOT/овольно:SUFF
добровольный	добр:ROOT/овольный:SUFF
добродетель	добр:ROOT/одетель:SUFF
добродетельный	добр:ROOT/одетельный:SUFF
добродушный	добр:ROOT/одушный:SUFF
добросердечный	добр:ROOT/осердечный:SUFF
добросовестно	добр:ROOT/осовестно:SUFF
добросовестный	добр:ROOT/осовестный:SUFF
доброта	добр:ROOT/ота:SUFF
добрый	добр:ROOT/ый:SUFF
добрыня	добр:ROOT/ыня:SUFF
добряк	добр:ROOT/як:SUFF
задобрить	за:PREF/добр:ROOT/ить:SUFF
подобреть	по:PREF/добр:ROOT/еть:SUFF
бездомный	без:PREF/дом:ROOT/ный:SUFF
домик	дом:ROOT/ик:SUFF
домина	дом:ROOT/ина:SUFF
домишко	дом:ROOT/ишко:SUFF
домище	дом:ROOT/ище:SUFF
домовитый	дом:ROOT/овитый:SUFF
домовладелец	дом:ROOT/овладелец:SUFF
домовладение	дом:ROOT/овладение:SUFF
домоводство	дом:ROOT/оводство:SUFF
домовой	дом:ROOT/овой:SUFF
домосед	дом:ROOT/осед:SUFF
домострой	дом:ROOT/острой:SUFF
домохозяйка	дом:ROOT/охозяйка:SUFF
домочадец	дом:ROOT/очадец:SUFF
домработница	дом:ROOT/работница:SUFF
домушник	дом:ROOT/ушник:SUFF
надомник	на:PREF/дом:ROOT/ник:SUFF
дружеский	друж:ROOT/еский:SUFF
дружественный	друж:ROOT/ественный:SUFF
дружина	друж:ROOT/ина:SUFF
дружинник	друж:ROOT/инник:SUFF
дружить	друж:ROOT/ить:SUFF
дружище	друж:ROOT/ище:SUFF
дружно	друж:ROOT/но:SUFF
дружный	друж:ROOT/ный:SUFF
содружество	со:PREF/друж:ROOT/ество:SUFF
дуб	дуб:ROOT
дубина	дуб:ROOT/ина:SUFF
дубинка	дуб:ROOT/инка:SUFF
дубинушка	дуб:ROOT/инушка:SUFF
дубняк	дуб:ROOT/няк:SUFF
дубовик	дуб:ROOT/овик:SUFF
дубовый	дуб:ROOT/овый:SUFF
дубок	дуб:ROOT/ок:SUFF
дубочек	дуб:ROOT/очек:SUFF
дубрава	дуб:ROOT/рава:SUFF
дубравушка	дуб:ROOT/равушка:SUFF
дубьё	дуб:ROOT/ьё:SUFF
коза	коз:ROOT/а:SUFF
козерог	коз:ROOT/ерог:SUFF
козий	коз:ROOT/ий:SUFF
козлик	коз:ROOT/лик:SUFF
козлиный	коз:ROOT/линый:SUFF
козлище	коз:ROOT/лище:SUFF
козлобородый	коз:ROOT/лобородый:SUFF
козлята	коз:ROOT/лята:SUFF
козлятина	коз:ROOT/лятина:SUFF
козлятник	коз:ROOT/лятник:SUFF
козлёнок	коз:ROOT/лёнок:SUFF
козочка	коз:ROOT/очка:SUFF
козёл	коз:ROOT/ёл:SUFF
колокол	кол:ROOT/о:SUFF
колоколенка	кол:ROOT/о:SUFF
колоколец	кол:ROOT/о:SUFF
колоколище	кол:ROOT/о:SUFF
колокольный	кол:ROOT/о:SUFF
колокольня	кол:ROOT/о:SUFF
колокольчик	кол:ROOT/о:SUFF
колокольчиковый	кол:ROOT/о:SUFF
кольцеброс	кольц:ROOT/еброс:SUFF
кольцевание	кольц:ROOT/евание:SUFF
кольцевидный	кольц:ROOT/евидный:SUFF
кольцевой	кольц:ROOT/евой:SUFF
кольцеобразный	кольц:ROOT/еобразный:SUFF
кольцо	кольц:ROOT/о:SUFF
окольцевать	о:PREF/кольц:ROOT/евать:SUFF
окольцованный	о:PREF/кольц:ROOT/ованный:SUFF
коневод	кон:ROOT/евод:SUFF
коневодство	кон:ROOT/еводство:SUFF
конезавод	кон:ROOT/езавод:SUFF
конеферма	кон:ROOT/еферма:SUFF
конина	кон:ROOT/ина:SUFF
конка	кон:ROOT/ка:SUFF
конник	кон:ROOT/ник:SUFF
конница	кон:ROOT/ница:SUFF
конный	кон:ROOT/ный:SUFF
коновал	кон:ROOT/овал:SUFF
коновязь	кон:ROOT/овязь:SUFF
конокрад	кон:ROOT/окрад:SUFF
конский	кон:ROOT/ский:SUFF
конюх	кон:ROOT/юх:SUFF
конюшня	кон:ROOT/юшня:SUFF
конёк	кон:ROOT/ёк:SUFF
ледник	лед:ROOT/ник:SUFF
ледниковый	лед:ROOT/никовый:SUFF
ледовый	лед:ROOT/овый:SUFF
ледок	лед:ROOT/ок:SUFF
ледокол	лед:ROOT/окол:SUFF
ледорез	лед:ROOT/орез:SUFF
ледоруб	лед:ROOT/оруб:SUFF
ледышка	лед:ROOT/ышка:SUFF
ледянка	лед:ROOT/янка:SUFF
ледяной	лед:ROOT/яной:SUFF
обледенение	об:PREF/лед:ROOT/енение:SUFF
лесистый	лес:ROOT/истый:SUFF
лесник	лес:ROOT/ник:SUFF
лесничество	лес:ROOT/ничество:SUFF
лесничий	лес:ROOT/ничий:SUFF
лесной	лес:ROOT/ной:SUFF
лесовик	лес:ROOT/овик:SUFF
лесозаготовка	лес:ROOT/озаготовка:SUFF
лесозащитный	лес:ROOT/озащитный:SUFF
лесок	лес:ROOT/ок:SUFF
лесопарк	лес:ROOT/опарк:SUFF
лесопилка	лес:ROOT/опилка:SUFF
лесоповал	лес:ROOT/оповал:SUFF
лесоруб	лес:ROOT/оруб:SUFF
лесосека	лес:ROOT/осека:SUFF
лесосплав	лес:ROOT/осплав:SUFF
лесостепь	лес:ROOT/остепь:SUFF
подлесок	под:PREF/лес:ROOT/ок:SUFF
полесье	по:PREF/лес:ROOT/ье:SUFF
вертолёт	верто:PREF/лёт:ROOT
взлёт	вз:PREF/лёт:ROOT
звездолёт	звездо:PREF/лёт:ROOT
лёт	лёт:ROOT
лётный	лёт:ROOT/ный:SUFF
лётчик	лёт:ROOT/чик:SUFF
перелёт	пере:PREF/лёт:ROOT
полёт	по:PREF/лёт:ROOT
самолёт	само:PREF/лёт:ROOT
лиственница	лист:ROOT/венница:SUFF
лиственный	лист:ROOT/венный:SUFF
листик	лист:ROOT/ик:SUFF
листовидный	лист:ROOT/овидный:SUFF
листовёртка	лист:ROOT/овёртка:SUFF
листоед	лист:ROOT/оед:SUFF
листок	лист:ROOT/ок:SUFF
листообразный	лист:ROOT/ообразный:SUFF
листопад	лист:ROOT/опад:SUFF
листочек	лист:ROOT/очек:SUFF
медведица	мед:ROOT/ведица:SUFF
медведка	мед:ROOT/ведка:SUFF
медведь	мед:ROOT/ведь:SUFF
медвежата	мед:ROOT/вежата:SUFF
медвежатник	мед:ROOT/вежатник:SUFF
медвежий	мед:ROOT/вежий:SUFF
медвежонок	мед:ROOT/вежонок:SUFF
медовый	мед:ROOT/овый:SUFF
медок	мед:ROOT/ок:SUFF
медонос	мед:ROOT/онос:SUFF
медосбор	мед:ROOT/осбор:SUFF
медуница	мед:ROOT/уница:SUFF
лосепитомник	лос:ROOT/епитомник:SUFF
лосеферма	лос:ROOT/еферма:SUFF
лосий	лос:ROOT/ий:SUFF
лосиный	лос:ROOT/иный:SUFF
лосиха	лос:ROOT/иха:SUFF
лось	лос:ROOT/ь:SUFF
лосята	лос:ROOT/ята:SUFF
лосятина	лос:ROOT/ятина:SUFF
лосёвый	лос:ROOT/ёвый:SUFF
лосёнок	лос:ROOT/ёнок:SUFF
лосёночек	лос:ROOT/ёночек:SUFF
заморозка	за:PREF/мороз:ROOT/ка:SUFF
заморозок	за:PREF/мороз:ROOT/ок:SUFF
морозец	мороз:ROOT/ец:SUFF
морозилка	мороз:ROOT/илка:SUFF
морозильник	мороз:ROOT/ильник:SUFF
морозить	мороз:ROOT/ить:SUFF
морозище	мороз:ROOT/ище:SUFF
морозный	мороз:ROOT/ный:SUFF
морозостойкий	мороз:ROOT/остойкий:SUFF
овощевод	овощ:ROOT/евод:SUFF
овощеводство	овощ:ROOT/еводство:SUFF
овощеводческий	овощ:ROOT/еводческий:SUFF
овощемоечный	овощ:ROOT/емоечный:SUFF
овощерезка	овощ:ROOT/ерезка:SUFF
овощесушилка	овощ:ROOT/есушилка:SUFF
овощехранилище	овощ:ROOT/ехранилище:SUFF
овощной	овощ:ROOT/ной:SUFF
обрадовать	об:PREF/рад:ROOT/овать:SUFF
радостно	рад:ROOT/остно:SUFF
радостный	рад:ROOT/остный:SUFF
радость	рад:ROOT/ость:SUFF
радушие	рад:ROOT/ушие:SUFF
радушный	рад:ROOT/ушный:SUFF
радующий	рад:ROOT/ующий:SUFF
радующийся	рад:ROOT/ующийся:SUFF
радёхонька	рад:ROOT/ёхонька:SUFF
радёшенек	рад:ROOT/ёшенек:SUFF
непобедимый	не:PREF/побед:ROOT/имый:SUFF
победа	побед:ROOT/а:SUFF
победивший	побед:ROOT/ивший:SUFF
победитель	побед:ROOT/итель:SUFF
победительница	побед:ROOT/ительница:SUFF
победить	побед:ROOT/ить:SUFF
победный	побед:ROOT/ный:SUFF
победоносный	побед:ROOT/оносный:SUFF
ракета	рак:ROOT/ета:SUFF
ракета-носитель	рак:ROOT/ета-носитель:SUFF
ракетница	рак:ROOT/етница:SUFF
ракетный	рак:ROOT/етный:SUFF
ракетодром	рак:ROOT/етодром:SUFF
ракетоносец	рак:ROOT/етоносец:SUFF
ракетостроение	рак:ROOT/етостроение:SUFF
ракетчик	рак:ROOT/етчик:SUFF
породниться	по:PREF/род:ROOT/ниться:SUFF
родина	род:ROOT/ина:SUFF
родители	род:ROOT/ители:SUFF
родительский	род:ROOT/ительский:SUFF
родиться	род:ROOT/иться:SUFF
родной	род:ROOT/ной:SUFF
родственник	род:ROOT/ственник:SUFF
родственный	род:ROOT/ственный:SUFF
снегирь	снег:ROOT/ирь:SUFF
снеговик	снег:ROOT/овик:SUFF
снегозадержание	снег:ROOT/озадержание:SUFF
снегокат	снег:ROOT/окат:SUFF
снегопад	снег:ROOT/опад:SUFF
снеготаяние	снег:ROOT/отаяние:SUFF
снегоуборка	снег:ROOT/оуборка:SUFF
снегоход	снег:ROOT/оход:SUFF
снегурочка	снег:ROOT/урочка:SUFF
зоосад	зоо:PREF/сад:ROOT
палисадник	пали:PREF/сад:ROOT/ник:SUFF
пересадка	пере:PREF/сад:ROOT/ка:SUFF
посадка	по:PREF/сад:ROOT/ка:SUFF
посадочный	по:PREF/сад:ROOT/очный:SUFF
рассада	рас:PREF/сад:ROOT/а:SUFF
рассадить	рас:PREF/сад:ROOT/ить:SUFF
садик	сад:ROOT/ик:SUFF
садовник	сад:ROOT/овник:SUFF
садовничий	сад:ROOT/овничий:SUFF
садовод	сад:ROOT/овод:SUFF
садоводство	сад:ROOT/оводство:SUFF
садовый	сад:ROOT/овый:SUFF
садочек	сад:ROOT/очек:SUFF
злословие	зло:PREF/слов:ROOT/ие:SUFF
послесловие	после:PREF/слов:ROOT/ие:SUFF
предисловие	преди:PREF/слов:ROOT/ие:SUFF
словарик	слов:ROOT/арик:SUFF
словарный	слов:ROOT/арный:SUFF
словарь	слов:ROOT/арь:SUFF
словесник	слов:ROOT/есник:SUFF
словесность	слов:ROOT/есность:SUFF
словесный	слов:ROOT/есный:SUFF
словечко	слов:ROOT/ечко:SUFF
слово	слов:ROOT/о:SUFF
словоизменение	слов:ROOT/оизменение:SUFF
словообразование	слов:ROOT/ообразование:SUFF
словоохотливый	слов:ROOT/оохотливый:SUFF
словосочетание	слов:ROOT/осочетание:SUFF
словотворчество	слов:ROOT/отворчество:SUFF
словоупотребление	слов:ROOT/оупотребление:SUFF
словцо	слов:ROOT/цо:SUFF
солнце	солнц:ROOT/е:SUFF
солнцеворот	солнц:ROOT/еворот:SUFF
солнцезащитный	солнц:ROOT/езащитный:SUFF
солнцелюбивый	солнц:ROOT/елюбивый:SUFF
солнцеобразный	солнц:ROOT/еобразный:SUFF
солнцепёк	солнц:ROOT/епёк:SUFF
солнцестояние	солнц:ROOT/естояние:SUFF
солнцестояние	солнц:ROOT/естояние:SUFF
недосол	недо:PREF/сол:ROOT
пересол	пере:PREF/сол:ROOT
солеварня	сол:ROOT/еварня:SUFF
солевой	сол:ROOT/евой:SUFF
соление	сол:ROOT/ение:SUFF
солить	сол:ROOT/ить:SUFF
солонец	сол:ROOT/онец:SUFF
солонец	сол:ROOT/онец:SUFF
солонина	сол:ROOT/онина:SUFF
солонка	сол:ROOT/онка:SUFF
солоноватый	сол:ROOT/оноватый:SUFF
солончак	сол:ROOT/ончак:SUFF
солянка	сол:ROOT/янка:SUFF
солёный	сол:ROOT/ёный:SUFF
спортзал	спорт:ROOT/зал:SUFF
спортивный	спорт:ROOT/ивный:SUFF
спортинвентарь	спорт:ROOT/инвентарь:SUFF
спортклуб	спорт:ROOT/клуб:SUFF
спорткомплекс	спорт:ROOT/комплекс:SUFF
спортлото	спорт:ROOT/лото:SUFF
спортобщество	спорт:ROOT/общество:SUFF
спортплощадка	спорт:ROOT/площадка:SUFF
спортсмен	спорт:ROOT/смен:SUFF
спортсменка	спорт:ROOT/сменка:SUFF
спорттовары	спорт:ROOT/товары:SUFF
застолье	за:PREF/стол:ROOT/ье:SUFF
застольный	за:PREF/стол:ROOT/ьный:SUFF
престол	пре:PREF/стол:ROOT
столик	стол:ROOT/ик:SUFF
столица	стол:ROOT/ица:SUFF
столичный	стол:ROOT/ичный:SUFF
столище	стол:ROOT/ище:SUFF
столоваться	стол:ROOT/оваться:SUFF
столовая	стол:ROOT/овая:SUFF
стольничий	стол:ROOT/ьничий:SUFF
стольный	стол:ROOT/ьный:SUFF
столяр	стол:ROOT/яр:SUFF
столярничать	стол:ROOT/ярничать:SUFF
столярный	стол:ROOT/ярный:SUFF
первоцвет	перво:PREF/цвет:ROOT
пустоцвет	пусто:PREF/цвет:ROOT
расцветать	рас:PREF/цвет:ROOT/ать:SUFF
соцветие	со:PREF/цвет:ROOT/ие:SUFF
цветение	цвет:ROOT/ение:SUFF
цветник	цвет:ROOT/ник:SUFF
цветовод	цвет:ROOT/овод:SUFF
цветочек	цвет:ROOT/очек:SUFF
цветочный	цвет:ROOT/очный:SUFF
цветущий	цвет:ROOT/ущий:SUFF
цветы	цвет:ROOT/ы:SUFF
похолодание	по:PREF/холод:ROOT/ание:SUFF
холодец	холод:ROOT/ец:SUFF
холодильник	холод:ROOT/ильник:SUFF
холодильный	холод:ROOT/ильный:SUFF
холодина	холод:ROOT/ина:SUFF
холодить	холод:ROOT/ить:SUFF
холодище	холод:ROOT/ище:SUFF
холодно	холод:ROOT/но:SUFF
холодновато	холод:ROOT/новато:SUFF
холоднокровный	холод:ROOT/нокровный:SUFF
холодок	холод:ROOT/ок:SUFF
холодостойкий	холод:ROOT/остойкий:SUFF
вездеход	везде:PREF/ход:ROOT
восход	вос:PREF/ход:ROOT
вход	в:PREF/ход:ROOT
выходить	вы:PREF/ход:ROOT/ить:SUFF
луноход	луно:PREF/ход:ROOT
переход	пере:PREF/ход:ROOT
поход	по:PREF/ход:ROOT
походка	по:PREF/ход:ROOT/ка:SUFF
теплоход	тепло:PREF/ход:ROOT
ходики	ход:ROOT/ики:SUFF
ходить	ход:ROOT/ить:SUFF
ходули	ход:ROOT/ули:SUFF
ходунки	ход:ROOT/унки:SUFF
нахлебник	на:PREF/хлеб:ROOT/ник:SUFF
хлебец	хлеб:ROOT/ец:SUFF
хлебница	хлеб:ROOT/ница:SUFF
хлебный	хлеб:ROOT/ный:SUFF
хлебобулочный	хлеб:ROOT/обулочный:SUFF
хлебозавод	хлеб:ROOT/озавод:SUFF
хлебозаготовка	хлеб:ROOT/озаготовка:SUFF
хлебопашец	хлеб:ROOT/опашец:SUFF
хлебопекарня	хлеб:ROOT/опекарня:SUFF
хлебопродукты	хлеб:ROOT/опродукты:SUFF
хлебопёк	хлеб:ROOT/опёк:SUFF
хлеборезка	хлеб:ROOT/орезка:SUFF
хлебороб	хлеб:ROOT/ороб:SUFF
хлебосол	хлеб:ROOT/осол:SUFF
хлебоуборочный	хлеб:ROOT/оуборочный:SUFF
хлебушек	хлеб:ROOT/ушек:SUFF
наушники	на:PREF/уш:ROOT/ники:SUFF
подушка	под:PREF/уш:ROOT/ка:SUFF
ушанка	уш:ROOT/анка:SUFF
ушастый	уш:ROOT/астый:SUFF
уши	уш:ROOT/и:SUFF
ушко	уш:ROOT/ко:SUFF
ушник	уш:ROOT/ник:SUFF
ушной	уш:ROOT/ной:SUFF
разнотравье	разно:PREF/трав:ROOT/ье:SUFF
трава	трав:ROOT/а:SUFF
травинка	трав:ROOT/инка:SUFF
травинушка	трав:ROOT/инушка:SUFF
травка	трав:ROOT/ка:SUFF
травник	трав:ROOT/ник:SUFF
травница	трав:ROOT/ница:SUFF
травонька	трав:ROOT/онька:SUFF
травополье	трав:ROOT/ополье:SUFF
травосеяние	трав:ROOT/осеяние:SUFF
травостой	трав:ROOT/остой:SUFF
травочка	трав:ROOT/очка:SUFF
травоядный	трав:ROOT/оядный:SUFF
травушка	трав:ROOT/ушка:SUFF
травянистый	трав:ROOT/янистый:SUFF
травяной	трав:ROOT/яной:SUFF
натренированный	на:PREF/трен:ROOT/ированный:SUFF
перетренироваться	пере:PREF/трен:ROOT/ироваться:SUFF
тренаж	трен:ROOT/аж:SUFF
тренажёр	трен:ROOT/ажёр:SUFF
тренер	трен:ROOT/ер:SUFF
тренерский	трен:ROOT/ерский:SUFF
тренинг	трен:ROOT/инг:SUFF
тренированный	трен:ROOT/ированный:SUFF
тренировать	трен:ROOT/ировать:SUFF
тренироваться	трен:ROOT/ироваться:SUFF
тренировка	трен:ROOT/ировка:SUFF
тренировочный	трен:ROOT/ировочный:SUFF
застройка	за:PREF/строй:ROOT/ка:SUFF
застройщик	за:PREF/строй:ROOT/щик:SUFF
надстройка	над:PREF/строй:ROOT/ка:SUFF
перестройка	пере:PREF/строй:ROOT/ка:SUFF
постройка	по:PREF/строй:ROOT/ка:SUFF
пристройка	при:PREF/строй:ROOT/ка:SUFF
стройбат	строй:ROOT/бат:SUFF
стройка	строй:ROOT/ка:SUFF
стройплощадка	строй:ROOT/площадка:SUFF
выигрывать	вы:PREF/игр:ROOT/ывать:SUFF
выигрыш	вы:PREF/игр:ROOT/ыш:SUFF
игра	игр:ROOT/а:SUFF
играть	игр:ROOT/ать:SUFF
играющий	игр:ROOT/ающий:SUFF
игривый	игр:ROOT/ивый:SUFF
игрище	игр:ROOT/ище:SUFF
игровой	игр:ROOT/овой:SUFF
игрок	игр:ROOT/ок:SUFF
игротека	игр:ROOT/отека:SUFF
игрун	игр:ROOT/ун:SUFF
игрушечный	игр:ROOT/ушечный:SUFF
игрушка	игр:ROOT/ушка:SUFF
наигрыш	на:PREF/игр:ROOT/ыш:SUFF
проигрыш	про:PREF/игр:ROOT/ыш:SUFF
каменистый	кам:ROOT/енистый:SUFF
каменка	кам:ROOT/енка:SUFF
каменный	кам:ROOT/енный:SUFF
каменотёс	кам:ROOT/енотёс:SUFF
каменщик	кам:ROOT/енщик:SUFF
камень	кам:ROOT/ень:SUFF
камнеломка	кам:ROOT/неломка:SUFF
камнеломня	кам:ROOT/неломня:SUFF
камнемёт	кам:ROOT/немёт:SUFF
камнеобработка	кам:ROOT/необработка:SUFF
камнепад	кам:ROOT/непад:SUFF
камнерез	кам:ROOT/нерез:SUFF
окаменеть	о:PREF/кам:ROOT/енеть:SUFF
карта	карт:ROOT/а:SUFF
картина	карт:ROOT/ина:SUFF
картинка	карт:ROOT/инка:SUFF
картинный	карт:ROOT/инный:SUFF
картишки	карт:ROOT/ишки:SUFF
картограф	карт:ROOT/ограф:SUFF
картография	карт:ROOT/ография:SUFF
картотека	карт:ROOT/отека:SUFF
карточка	карт:ROOT/очка:SUFF
кожа	кож:ROOT/а:SUFF
кожанка	кож:ROOT/анка:SUFF
кожаный	кож:ROOT/аный:SUFF
кожевник	кож:ROOT/евник:SUFF
кожеед	кож:ROOT/еед:SUFF
кожемяка	кож:ROOT/емяка:SUFF
кожзаменитель	кож:ROOT/заменитель:SUFF
кожица	кож:ROOT/ица:SUFF
кожник	кож:ROOT/ник:SUFF
кожный	кож:ROOT/ный:SUFF
кожура	кож:ROOT/ура:SUFF
кожух	кож:ROOT/ух:SUFF
кожушок	кож:ROOT/ушок:SUFF
подкожный	под:PREF/кож:ROOT/ный:SUFF
зернистый	зерн:ROOT/истый:SUFF
зерно	зерн:ROOT/о:SUFF
зерновой	зерн:ROOT/овой:SUFF
зернодробилка	зерн:ROOT/одробилка:SUFF
зерноочистка	зерн:ROOT/оочистка:SUFF
зерноуборочный	зерн:ROOT/оуборочный:SUFF
зернохранилище	зерн:ROOT/охранилище:SUFF
зима	зим:ROOT/а:SUFF
зимний	зим:ROOT/ний:SUFF
зимник	зим:ROOT/ник:SUFF
зимовать	зим:ROOT/овать:SUFF
зимовка	зим:ROOT/овка:SUFF
зимовщик	зим:ROOT/овщик:SUFF
зимовье	зим:ROOT/овье:SUFF
зимородок	зим:ROOT/ородок:SUFF
зимостойкий	зим:ROOT/остойкий:SUFF
зимушка	зим:ROOT/ушка:SUFF
зимующий	зим:ROOT/ующий:SUFF
озимый	о:PREF/зим:ROOT/ый:SUFF
озимь	о:PREF/зим:ROOT/ь:SUFF
перезимовать	пере:PREF/зим:ROOT/овать:SUFF
по-зимнему	по-:PREF/зим:ROOT/нему:SUFF
предзимний	пред:PREF/зим:ROOT/ний:SUFF
предзимье	пред:PREF/зим:ROOT/ье:SUFF
заземление	за:PREF/земл:ROOT/ение:SUFF
землевладелец	земл:ROOT/евладелец:SUFF
земледелец	земл:ROOT/еделец:SUFF
земледелие	земл:ROOT/еделие:SUFF
землекоп	земл:ROOT/екоп:SUFF
землемер	земл:ROOT/емер:SUFF
землепашец	земл:ROOT/епашец:SUFF
землетрясение	земл:ROOT/етрясение:SUFF
землица	земл:ROOT/ица:SUFF
земля	земл:ROOT/я:SUFF
земляк	земл:ROOT/як:SUFF
земляника	земл:ROOT/яника:SUFF
землянин	земл:ROOT/янин:SUFF
землянка	земл:ROOT/янка:SUFF
земляной	земл:ROOT/яной:SUFF
землячка	земл:ROOT/ячка:SUFF
жар-птица	жар:ROOT/-птица:SUFF
жара	жар:ROOT/а:SUFF
жареный	жар:ROOT/еный:SUFF
жарить	жар:ROOT/ить:SUFF
жарища	жар:ROOT/ища:SUFF
жарко	жар:ROOT/ко:SUFF
жаркое	жар:ROOT/кое:SUFF
жаровня	жар:ROOT/овня:SUFF
жаропрочный	жар:ROOT/опрочный:SUFF
зажарить	за:PREF/жар:ROOT/ить:SUFF
поджарить	под:PREF/жар:ROOT/ить:SUFF
поджарка	под:PREF/жар:ROOT/ка:SUFF
пожар	по:PREF/жар:ROOT
пожарник	по:PREF/жар:ROOT/ник:SUFF
пожарный	по:PREF/жар:ROOT/ный:SUFF
прожарить	про:PREF/жар:ROOT/ить:SUFF
вызвездить	вы:PREF/звезд:ROOT/ить:SUFF
звезда	звезд:ROOT/а:SUFF
звездолёт	звезд:ROOT/олёт:SUFF
звездообразный	звезд:ROOT/ообразный:SUFF
звездопад	звезд:ROOT/опад:SUFF
звездоплавание	звезд:ROOT/оплавание:SUFF
звездочёт	звезд:ROOT/очёт:SUFF
созвездие	со:PREF/звезд:ROOT/ие:SUFF
звереть	звер:ROOT/еть:SUFF
зверинец	звер:ROOT/инец:SUFF
звериный	звер:ROOT/иный:SUFF
зверовод	звер:ROOT/овод:SUFF
зверолов	звер:ROOT/олов:SUFF
звероферма	звер:ROOT/оферма:SUFF
зверски	звер:ROOT/ски:SUFF
зверский	звер:ROOT/ский:SUFF
зверство	звер:ROOT/ство:SUFF
зверствовать	звер:ROOT/ствовать:SUFF
зверьё	звер:ROOT/ьё:SUFF
зверюга	звер:ROOT/юга:SUFF
зверюшка	звер:ROOT/юшка:SUFF
зверёк	звер:ROOT/ёк:SUFF
зверёныш	звер:ROOT/ёныш:SUFF
озвереть	о:PREF/звер:ROOT/еть:SUFF
дозвониться	до:PREF/звон:ROOT/иться:SUFF
зазвонить	за:PREF/звон:ROOT/ить:SUFF
звонарь	звон:ROOT/арь:SUFF
звонит	звон:ROOT/ит:SUFF
звонкий	звон:ROOT/кий:SUFF
звонко	звон:ROOT/ко:SUFF
звонкоголосый	звон:ROOT/коголосый:SUFF
звонница	звон:ROOT/ница:SUFF
звонок	звон:ROOT/ок:SUFF
звоночек	звон:ROOT/очек:SUFF
звонче	звон:ROOT/че:SUFF
озвончение	о:PREF/звон:ROOT/чение:SUFF
перезвон	пере:PREF/звон:ROOT
перезвонить	пере:PREF/звон:ROOT/ить:SUFF
трезвон	тре:PREF/звон:ROOT
трезвонить	тре:PREF/звон:ROOT/ить:SUFF
гусельки	гус:ROOT/ельки:SUFF
гусляр	гус:ROOT/ляр:SUFF
гуслярный	гус:ROOT/лярный:SUFF
гуслярский	гус:ROOT/лярский:SUFF
дорогой	дорог:ROOT/ой:SUFF
дорого	дорог:ROOT/о:SUFF
дороговато	дорог:ROOT/овато:SUFF
дороговизна	дорог:ROOT/овизна:SUFF
зубрище	зубр:ROOT/ище:SUFF
зубробизон	зубр:ROOT/обизон:SUFF
зубрёнок	зубр:ROOT/ёнок:SUFF
зубрёночек	зубр:ROOT/ёночек:SUFF
вызубрить	вы:PREF/зубр:ROOT/ить:SUFF
зазубрить	за:PREF/зубр:ROOT/ить:SUFF
зубрилка	зубр:ROOT/илка:SUFF
зубрёжка	зубр:ROOT/ёжка:SUFF
судовладелец	суд:ROOT/овладелец:SUFF
судовой	суд:ROOT/овой:SUFF
судостроение	суд:ROOT/остроение:SUFF
судоходный	суд:ROOT/оходный:SUFF
судёнышко	суд:ROOT/ёнышко:SUFF
неподсудный	непод:PREF/суд:ROOT/ный:SUFF
подсудимый	под:PREF/суд:ROOT/имый:SUFF
судейство	суд:ROOT/ейство:SUFF
судимость	суд:ROOT/имость:SUFF
судить	суд:ROOT/ить:SUFF
судопроизводство	суд:ROOT/опроизводство:SUFF
судья	суд:ROOT/ья:SUFF
междуречье	между:PREF/реч:ROOT/ье:SUFF
поречье	по:PREF/реч:ROOT/ье:SUFF
реченька	реч:ROOT/енька:SUFF
речка	реч:ROOT/ка:SUFF
речник	реч:ROOT/ник:SUFF
речной	реч:ROOT/ной:SUFF
речонка	реч:ROOT/онка:SUFF
изречение	из:PREF/реч:ROOT/ение:SUFF
оречевление	о:PREF/реч:ROOT/евление:SUFF
речевой	реч:ROOT/евой:SUFF
речетатив	реч:ROOT/етатив:SUFF
речистый	реч:ROOT/истый:SUFF
пораньше	по:PREF/ран:ROOT/ьше:SUFF
раненько	ран:ROOT/енько:SUFF
ранний	ран:ROOT/ний:SUFF
рановато	ран:ROOT/овато:SUFF
рань	ран:ROOT/ь:SUFF
раньше	ран:ROOT/ьше:SUFF
израненный	из:PREF/ран:ROOT/енный:SUFF
поранить	по:PREF/ран:ROOT/ить:SUFF
ранение	ран:ROOT/ение:SUFF
раненый	ран:ROOT/еный:SUFF
ранить	ран:ROOT/ить:SUFF
ранка	ран:ROOT/ка:SUFF
заработок	за:PREF/раб:ROOT/оток:SUFF
подработка	под:PREF/раб:ROOT/отка:SUFF
работать	раб:ROOT/отать:SUFF
работник	раб:ROOT/отник:SUFF
работница	раб:ROOT/отница:SUFF
работящий	раб:ROOT/отящий:SUFF
рабочий	раб:ROOT/очий:SUFF
рабовладение	раб:ROOT/овладение:SUFF
раболепие	раб:ROOT/олепие:SUFF
рабский	раб:ROOT/ский:SUFF
рабство	раб:ROOT/ство:SUFF
рабыня	раб:ROOT/ыня:SUFF
носилки	нос:ROOT/илки:SUFF
носильщик	нос:ROOT/ильщик:SUFF
носитель	нос:ROOT/итель:SUFF
переноска	пере:PREF/нос:ROOT/ка:SUFF
поднос	под:PREF/нос:ROOT
снос	с:PREF/нос:ROOT
длинноносый	длинно:PREF/нос:ROOT/ый:SUFF
носатый	нос:ROOT/атый:SUFF
носик	нос:ROOT/ик:SUFF
носовой	нос:ROOT/овой:SUFF
носорог	нос:ROOT/орог:SUFF
утконос	утко:PREF/нос:ROOT
молодецкий	молод:ROOT/ецкий:SUFF
молодчага	молод:ROOT/чага:SUFF
молодчик	молод:ROOT/чик:SUFF
молодчина	молод:ROOT/чина:SUFF
молоденький	молод:ROOT/енький:SUFF
молодка	молод:ROOT/ка:SUFF
молодняк	молод:ROOT/няк:SUFF
молодость	молод:ROOT/ость:SUFF
молодушка	молод:ROOT/ушка:SUFF
молодёжь	молод:ROOT/ёжь:SUFF
куриный	кур:ROOT/иный:SUFF
курица	кур:ROOT/ица:SUFF
курицын	кур:ROOT/ицын:SUFF
курник	кур:ROOT/ник:SUFF
куровод	кур:ROOT/овод:SUFF
куроед	кур:ROOT/оед:SUFF
курочка	кур:ROOT/очка:SUFF
курятина	кур:ROOT/ятина:SUFF
курятник	кур:ROOT/ятник:SUFF
закурить	за:PREF/кур:ROOT/ить:SUFF
курилка	кур:ROOT/илка:SUFF
курильщик	кур:ROOT/ильщик:SUFF
окурок	о:PREF/кур:ROOT/ок:SUFF
купец	куп:ROOT/ец:SUFF
купечество	куп:ROOT/ечество:SUFF
купленный	куп:ROOT/ленный:SUFF
купля	куп:ROOT/ля:SUFF
покупать	по:PREF/куп:ROOT/ать:SUFF
покупка	по:PREF/куп:ROOT/ка:SUFF
искупаться	ис:PREF/куп:ROOT/аться:SUFF
купава	куп:ROOT/ава:SUFF
купальник	куп:ROOT/альник:SUFF
купальный	куп:ROOT/альный:SUFF
купание	куп:ROOT/ание:SUFF
купель	куп:ROOT/ель:SUFF
кормилец	корм:ROOT/илец:SUFF
кормить	корм:ROOT/ить:SUFF
кормление	корм:ROOT/ление:SUFF
кормушка	корм:ROOT/ушка:SUFF
кормёжка	корм:ROOT/ёжка:SUFF
накормить	на:PREF/корм:ROOT/ить:SUFF
подкормка	под:PREF/корм:ROOT/ка:SUFF
кормило	корм:ROOT/ило:SUFF
кормовой	корм:ROOT/овой:SUFF
кормчий	корм:ROOT/чий:SUFF
кормщик	корм:ROOT/щик:SUFF
вокруг	во:PREF/круг:ROOT
круглый	круг:ROOT/лый:SUFF
кругляк	круг:ROOT/ляк:SUFF
кругом	круг:ROOT/ом:SUFF
красавица	крас:ROOT/авица:SUFF
красавка	крас:ROOT/авка:SUFF
красавчик	крас:ROOT/авчик:SUFF
красивенький	крас:ROOT/ивенький:SUFF
красивый	крас:ROOT/ивый:SUFF
красоваться	крас:ROOT/оваться:SUFF
красота	крас:ROOT/ота:SUFF
красотка	крас:ROOT/отка:SUFF
краснеть	крас:ROOT/неть:SUFF
красноватый	крас:ROOT/новатый:SUFF
красногрудый	крас:ROOT/ногрудый:SUFF
краснота	крас:ROOT/нота:SUFF
краснощёкий	крас:ROOT/нощёкий:SUFF
краснуха	крас:ROOT/нуха:SUFF
красильный	крас:ROOT/ильный:SUFF
красильня	крас:ROOT/ильня:SUFF
красильщик	крас:ROOT/ильщик:SUFF
краситель	крас:ROOT/итель:SUFF
красить	крас:ROOT/ить:SUFF
краска	крас:ROOT/ка:SUFF
краскопульт	крас:ROOT/копульт:SUFF
окрас	о:PREF/крас:ROOT
подкрасить	под:PREF/крас:ROOT/ить:SUFF
раскраска	рас:PREF/крас:ROOT/ка:SUFF
